Humans: 500
XXXXXXXXXXXXXXXXXXXXXXXXXXXXXXXXXXXXXXXXXXXXXXXXXXXXXXXXXXXXXXXXXXXXXXXXXXXXXXXXXXXXXXXXXXXXXXXXXXXXXXXXXXXXXXXX
X..............................................................................................................X
X..............................................................................................................X
X..............................................................................................................X
X..............................................................................................................X
X..............................................................................................................X
X..............................................................................................................X
X..............................................................................................................X
X..............................................................................................................X
X..............................................................................................................X
X..............................................................................................................X
X..............................................................................................................X
X..............................................................................................................X
X..............................................................................................................X
X..............................................................................................................X
X..............................................................................................................X
X..............................................................................................................X
X..............................................................................................................X
X..............................................................................................................X
X..............................................................................................................X
X..............................................................................................................X
X..............................................................................................................X
X..............................................................................................................X
X..............................................................................................................X
X..............................................................................................................X
X..............................................................................................................X
X..............................................................................................................X
X..............................................................................................................X
X..............................................................................................................X
X..............................................................................................................X
X..............................................................................................................X
X..............................................................................................................X
X..............................................................................................................X
X..............................................................................................................X
X..............................................................................................................X
X..............................................................................................................X
X..............................................................................................................X
X..............................................................................................................X
X..............................................................................................................X
X..............................................................................................................X
X..............................................................................................................X
X..............................................................................................................X
X..............................................................................................................X
X..............................................................................................................X
X..............................................................................................................X
X..............................................................................................................X
X..............................................................................................................X
X..............................................................................................................X
X..............................................................................................................X
X....................................................................................................@.....A...X
X..............................................................................................................X
XXXXXXXXXXXXXXXXXXXXXXXXXXXXXXXXXXXXXXXXXXXXXXXXXXXXXXXXXXXXXXXXXXXXXXXXXXXXXXXXXXXXXXXXXXXXXXXXXXXXXXXXXXXXXXXX