Humans: 200
RRRRRRRRRRRRRRRRRRRRRRRRRRRRRRRRRRRRRRRRRRRRRRRRRRRRRRRRRRRRRRRRRRRRRRRRRRRRRRRRRRRRRRRRRRRRRRRRRRRRRRRRRRRRRRRRRRRRRRRRRRRRRRRRRRRRRRRRRRRRRRRRRRRRRRRRRRRRRRRRRRRRRRRRRRRRRRRRRRRRRRRRRRRRRRRRRRRRRRRR
R......................................................................................................................................................................................................R
R.@.....AAA............................................................................................................................................................................................R
R......................................................................................................................................................................................................R
R......................................................................................................................................................................................................R
R...........RRRGRGRRR.....RRRRRGGRRRRR.................LGGLBBBBLGGLBBBBLGGL............................................................................................................................R
R...........R.......R.....G..........L.................L....B........B....L........BBBGBBGBBGBB.BBGBBGBBGBBB....BBBGBBGBBGBB.BBGBBGBBGBBB..............................................................R
R...........R.......L.....L............................G....B........B....G........B......B.........B......B....B......B.........B......B..............................................................R
R...........R........................L.................B....B........B....B........BBBBBB.............BBBBBB....BBBBBB.............BBBBBB..............................................................R
R...........R.......L.....L.....RRRRRR......................B........B.............L.......................L....L.......................L..............................................................R
R...........RRRGRGRRR.....G..........R.................B....BBBL..LBBB....B............................................................................................................................R
R.........................RRRRRGGRRRRR.................G..................G............................................................................................................................R
R......................................................L..................L........L.......................L....L.......................L..............................................................R
R......................................................LGGLBBBBL..LBBBBLGGL........B.......................B....B.......................B..............................................................R
R..................................................................................B.......................B....B.......................B..............................................................R
R..................................................................................BBBGBBGBBGBB.BBGBBGBBGBBB....BBBGBBGBBGBB.BBGBBGBBGBBB..............................................................R
R......................................................................................................................................................................................................R
R................................................................BBGGBL..LBGGBB........................................................................................................................R
R..........LLLLLGGGLLLLLLLLLLLLGGGLLLLL......BGBBGB..............B............B........................................................................................................................R
R..........L.............L............L......B....B..............B............B........................................................................................................................R
R..........G.............L............G......B....G..............L............L........................................................................................................................R
R..........LLLLLLL.LLLLLLLLLLLLL.LLLLLL...........G....................................................................................................................................................R
R............................................B....B..............L............L........................................................................................................................R
R............................................BGBBGB..............B............B........................................................................................................................R
R..........LLLL.LLLLLLLLL.LLLLLLLL.LLLL..........................B............B............LLB.BLL......................LLB.BLL........................................................................R
R..........G.......L..........L.......G..........................BBGGBL..LBGGBB............B.....B......................B.....B........................................................................R
R..........L.......L..........L.......L..........................................................B............................B........................................................................R
R..........LLLL.LLLLLLLLL.LLLLLLLL.LLLL......RRR.RRR.......................................B............................B..............................................................................R
R............................................R.....R.......................................B.....B......................B.....B........................................................................R
R..........................................................................................LLGGGLL......................LLGGGLL........................................................................R
R............................................R.....R...................................................................................................................................................R
R............................................R.....R...................................................................................................................................................R
R............................................R.....R...................................................................................................................................................R
R............................................R.....R...................................................................................................................................................R
R............................................R.....R...................................................................................................................................................R
R............................................RRR.RRR...................................................................................................................................................R
R......................................................................................................................................................................................................R
R......................................................................................................................................................................................................R
R...................................................................................BBGGBL..LBGGBB.....................................................................................................R
R...................................................................................B............B.....................................................................................................R
R....................RRRRRGGRRRRR...................................................B............B.....................................................................................................R
R....................G..........L...................................................L............L.....................................................................................................R
R....................L.................................................................................................................................................................................R
R...............................L...................................................L............L.....................................................................................................R
R....................L.....RRRRRR...................................................B............B.....................................................................................................R
R....................G..........R...................................................B............B.....................................................................................................R
R....................RRRRRGGRRRRR...................................................BBGGBL..LBGGBB.....................................................................................................R
R......................................................................................................................................................................................................R
RRRRRRRRRRRRRRRRRRRRRRRRRRRRRRRRRRRRRRRRRRRRRRRRRRRRRRRRRRRRRRRRRRRRRRRRRRRRRRRRRRRRRRRRRRRRRRRRRRRRRRRRRRRRRRRRRRRRRRRRRRRRRRRRRRRRRRRRRRRRRRRRRRRRRRRRRRRRRRRRRRRRRRRRRRRRRRRRRRRRRRRRRRRRRRRRRRRRRRRR